1111111111111111111111111111111111111
1000000000000000000000000000000000011
111000000000000C000011110000000011111
1111100000111100000111111000000001111
1100000000111000000001110000000001111
1001110000001000000000100000000110001
1100P1000000110000000000000000000E001
1111111111111111111111111111111111111
