1111111111111111111111111111111111111
1000000000000000000000000000000000011
1110000000000000000011110000000011111
1111100000111100000111111000000001111
1100000000111000000001110000000001111
1001110000001000000000100000000110001
1100P100000011000000000000E0000000C01
1111111111111111111111111111111111111
