1111111111
1P000E00C1
1111111111
