11111111111111111111111111111111111
1P00000000000000000C111111110000001
111111111111000001111111000000C0001
1000000111110000011111CC00000000001
10010000001111000111111100001110001
10011110000011000000011100111000011
1001C010000010C00000111000001100111
10010010001111100000011110001000011
10110011001110000000111000011100011
10010001001111110000011100001100011
10011001100011000000011000001100011
100011011000C0111100011100011110011
10011001110001110000001100011000011
10011001110001110000001100110001111
10011000000011000000111001111000011
1001111111111111000001100001110E011
1C000000000000000C000000000C1111111
11111111111111111111111111111111111
