11111111111111111
10000000000000001
10000001111000001
1000E00011000C001
1P000000010000001
11111111111111111
