11111111111111111
100C0000000000001
10000001111000001
10000000110000001
1P0000000100000E1
11111111111111111
