1111111111
1000000001
1010101011
1010101011
1000P00001
1C000000E1
1111111111
